R 1090 1080

SO srcs/textures/stone.xpm
WE srcs/textures/purplestone.xpm
EA srcs/textures/wood.xpm


S srcs/textures/barrel.xpm


C 117, 145, 209
F 153, 93, 3

NO srcs/textures/mossy.xpm
        1111111111111111111111111
        1000000000110000000000001
        1011000001110000002000001
        1001000000000000000000001
111111111011000001110000000000001
100000000011002001110111110110001
111101111111110111000000100011111
11110111111111011101010010001
110000001100010111000000100001
10002000000E00001100000010001
10000000000000001101010010001
1100000111010101111101111000111
11110111 1110101 101111010001
11111111 1111111 111111111111
11111111111111111111111111111

