R 1080 1090

NO srcs/textures/mossy.xpm
SO srcs/textures/stone.xpm
WE srcs/textures/purplestone.xpm
EA srcs/textures/wood.xpm


S srcs/textures/barrel.xpm


C 117, 145, 209
F 153, 93, 3

        11111111111111111111111111111
        100000000011001111000000001
        101100000111000000002000001
        100100000000000000000000111
111111111011000001110000000000001
100000000011002001110111110110001
111101111111110111000000100011111
11110111111111011101010010001
110000001100010111000000100001
10002000000E00001100000010001
10000000000000001101010010001
110000011101010111111111100111111111
11110111  1110101      1110111 1010011111
11110111  1110101      111011  11010001
11111111111111111111111111111111111111
11111111111111111111111111111


