R 1090 1080

NO srcs/textures/mossy.xpm
SO srcs/textures/stone.xpm
WE srcs/textures/wood1.xpm
EA srcs/textures/wood.xpm

S srcs/textures/barrel.xpm

F 230,100,0
C 225,30,0

        1111111111111111111111111
        1000000000110000000000001
        1011000001110000002000001
        1001000000000000000000001
111111111011000001110000000000001
100000000011000001110111110111111
11110111111111011100000010001
11110111111111011101010010001
11000000110101011100000010001
10002000000S00001100000010001
10000000000200001101010010001
1100000111010101111101111000111
11110111 1110101 101111010001
11111111 1111111 111111111111
11111111111111111111111111111

